#########################################################################################
#.......................................................................................#
#.......................................................................................#
#.......................................................................................#
#.......................................................................................#
#.......................................................................................#
#.......................................................................................#
#.......................................................................................#
#.......................................................................................#
#.......................................................................................#
#.......................................................................................#
#.......................................................................................#
#.......................................................................................#
#.......................................................................................#
#.......................................................................................#
#.......................................................................................#
#.......................................................................................#
#.......................................................................................#
#..........................................................+............................#
#.......................................................................................#
#.......................................................................................#
#.......................................................................................#
#.......................................................................................#
#.......................................................................................#
#.......................................................................................#
#.......................................................................................#
#.......................................................................................#
#.......................................................................................#
#.......................................................................................#
#########################################################################################

