#########################################################################################
#.......................................................................................#
#.......................................................................................#
#.......................................................................................#
#.................~~~~~.................................................................#
#................~~~~~~~~...............................................................#
#................~~~~~~~~~~~~...........................................................#
#................~~~~~~~~~~~~~~~~.......................................................#
#................~~~~~~~~~~~~~~~~~~~....................................................#
#..................~~~~~~~~~~~~~~~~~....................................................#
#...................~~~~~~~~~~~~~~~~~...................................................#
#....................~~~~~~~~~~~~.......................................................#
#......................~~~~~~~~~~~~~~...................................................#
#.......................~~~~~~~~~~~~~~~~~~~.............................................#
#..........................~~~~~~~~~~~~~~~~~~~..........................................#
#.............................~~~~~~~~~~~~~~~~~~........................................#
#...........................~~~~~~~~~~~~~~~~~~~~~~......................................#
#.........................~~~~~~~~~~~~~~~~~~~~~~~~~~....................................#
#..........................~~~~~~~~~~~~~~~~~~~~~...........+............................#
#..........................~~~~~~~~~~~~~~~~.............................................#
#........................~~~~~~~~~~~~~~~................................................#
#..........................~~~~~~~~~~...................................................#
#.............................~~~.......................................................#
#.......................................................................................#
#.......................................................................................#
#.......................................................................................#
#.......................................................................................#
#.......................................................................................#
#.......................................................................................#
#########################################################################################
